Maggot Brain - Funkadelic
DLZ - TV on the Radio
Clair de Lune - Claude Debussy
The Great Gig in the Sky - Pink Floyd
She Wanted to Leave - Ween
Do You Realize?? - The Flaming Lips
No Hard Feelings - The Avett Brothers
Give Up the Funk (Tear the Roof off the Sucker) - Parliament
Eclipse - Pink Floyd
Just Let Go - Sturgill Simpson
Always Look on the Bright Side of Life - Monty Python
Highway to Hell - AC/DC
Stairway to Heaven - Led Zeppelin
Comfortably Numb - Pink Floyd
A Day in the Life - The Beatles
Bittersweet Symphony - The Verve
Moonage Daydream - David Bowie
Shine On You Crazy Diamond - Pink Floyd
Hallelujah - Jeff Buckley
In My Life - The Beatles
Brothers in Arms - Dire Straits
Symphony No. 9, 4th movement (Ode to Joy) - Ludwig van Beethoven
Seven Bridges Road - Eagles
Asleep - The Smiths
Cambridge 1969 - Yoko Ono
Grace - Jeff Buckley
That’s Life - Frank Sinatra
Pink Cigarette - Mr. Bungle
Nutshell (Unplugged) - Alice in Chains
Speak to Me / Breathe / On the Run (Dark Side segs) - Pink Floyd
Trapeze Swinger - Iron & Wine
Good News - Mac Miller
God Hates a Coward - Tomahawk
Sinnerman - Nina Simone
Space Song - Beach House
My Life - Iris DeMent
Not Dark Yet - Bob Dylan
Time (cover) - Tori Amos (original: Tom Waits)
Fields of Gold - Sting
Dogs - Pink Floyd
Well I Wonder - The Smiths
Hurt - Nine Inch Nails
Welcome to the Black Parade - My Chemical Romance
Reflection - Tool
Inside My Mind (Blue Skies) - Groove Armada
i love you i'm sorry - Gracie Abrams
Let It Be - The Beatles
I Will Survive - Gloria Gaynor
Blue (Cowboy Bebop OST) - Yoko Kanno / Seatbelts
Hammer to Fall - Queen
Back to the Middle - Modest Mouse
Can't Keep - Eddie Vedder
Rockin' in the Free World - Neil Young
La Grange - ZZ Top
Plainsong - The Cure
War Ensemble - Slayer
It's a Man's Man's Man's World (live) - James Brown
When the Music's Over - The Doors
Judith - A Perfect Circle
Wake Up - Mad Season
Nothing - Depeche Mode
Lifetime - Three Days Grace
What a Wonderful World - Louis Armstrong
Trees - Twenty One Pilots
White Ferrari - Frank Ocean
Ghost Town - Kanye West
Chop Suey! - System Of A Down
Up&Up (live in Buenos Aires) - Coldplay
Like Toy Soldiers / When I'm Gone - Eminem
Welcome Home (Sanitarium) - Metallica
My Sweet Lord - George Harrison
3 Libras - A Perfect Circle
Wuthering Heights - Kate Bush
Goodbye So Soon - Vincent Price (from The Great Mouse Detective)
Nature's Revenge - Skinny Puppy
Life Is Strange - Lord Huron
How to Disappear Completely - Radiohead
Buckskin Stallion - Townes Van Zandt
Moon River - Andy Williams
The Song That Never Ends - (Lamb Chop / Traditional)
4 EVER 4 ME - Demi Lovato
Please Don't Bury Me - John Prine
Remember Me - Tame Impala
All I Want for Christmas Is You - Mariah Carey
Autumn Leaves (Cannonball Adderley version) - Cannonball Adderley
Sing About Me, I'm Dying of Thirst - Kendrick Lamar
Breathe - Pink Floyd
Little Wing - Jimi Hendrix
Old and Wise - Alan Parsons Project
Cool Change - Little River Band
Collapse the Light Into Earth - Porcupine Tree
Kashmir - Led Zeppelin
Astronomy (live) - Blue Öyster Cult
Videotape - Radiohead
Farewell and Goodnight - The Smashing Pumpkins
Airbag - Radiohead
Roll Me Away - Bob Seger
Where Is My Mind? - Pixies
Everlong - Foo Fighters
You Can't Always Get What You Want - The Rolling Stones